


NO ./resource/image/north_texture.xpm

SO ./resource/image/south_texture.xpm
WE ./resource/image/west_texture.xpm
EA ./resource/image/east_texture.xpm

F 93,173,236
C 255,255,230

 111111
1E000001
 111101
1    1
1
