


NO ./resorce/image/wall0.xpm
SO ./resorce/image/wall1.xpm
WE ./resorce/image/wall2.xpm
EA ./resorce/image/wall3.xpm

F 255,100,0
C 225,30,1

 111111
1S000001
 111101
1    1
1
